AttreyeeJune14	/media/prr/PRR/Optitrack/Data/Bangla/AttreyeeJune14/FBX
PrasantaMay31	/media/prr/PRR/Optitrack/Data/Bangla/PrasantaMay31/FBX
SamikJune3	/media/prr/PRR/Optitrack/Data/Bangla/SamikJune3/FBX
TanayaJune1	/media/prr/PRR/Optitrack/Data/Bangla/TanayaJune1/FBX
Gaurav	/media/prr/PRR/Optitrack/Data/Hindi/Gaurav/May26/FBX
Paridhi	/media/prr/PRR/Optitrack/Data/Hindi/Paridhi/FBX
Salma	/media/prr/PRR/Optitrack/Data/Hindi/Salma/May27/FBX
Sanjeev	/media/prr/PRR/Optitrack/Data/Hindi/Sanjeev/FBX
Kausthubha	/media/prr/PRR/Optitrack/Data/Kannada/Kausthubha/May25/FBX
Mekhala	/media/prr/PRR/Optitrack/Data/Kannada/Mekhala/May27/FBX
PavanIn	/media/prr/PRR/Optitrack/Data/Kannada/PavanIn/May28/FBX
Akshara	/media/prr/PRR/Optitrack/Data/Malayalam/Akshara/FBX
Anand	/media/prr/PRR/Optitrack/Data/Malayalam/Anand/FBX
Karthik	/media/prr/PRR/Optitrack/Data/Malayalam/Karthik/FBX
Nazreen	/media/prr/PRR/Optitrack/Data/Malayalam/Nazreen/FBX
Ashwini	/media/prr/PRR/Optitrack/Data/Tamil/Ashwini/FBX
Nisha	/media/prr/PRR/Optitrack/Data/Tamil/Nisha/FBX
Vaidhya	/media/prr/PRR/Optitrack/Data/Tamil/Vaidhya/FBX
Valliappam	/media/prr/PRR/Optitrack/Data/Tamil/Valliappam/FBX
Anusha	/media/prr/PRR/Optitrack/Data/Telugu/Anusha/FBX
Aravind	/media/prr/PRR/Optitrack/Data/Telugu/Aravind/FBX
Nithin	/media/prr/PRR/Optitrack/Data/Telugu/Nithin/May26/FBX
Sushila	/media/prr/PRR/Optitrack/Data/Telugu/Sushila/FBX
